BACKWARD	B AE K W ER D
DIX	D IH K S
DIXON	D IH K S AH N
DOOR	D AO R
DOWN	D AW N
FENN	F EH N
FH	EH F
FORWARD	F AO R W ER D
GO	G OW
HALL	HH AO L
HALT	HH AO L T
HEAD	HH EH D
HEY	HH EY
LEFT	L EH F T
MOVE	M UW V
OFFICE	AO F AH S
PLEASE	P L IY Z
RIGHT	R AY T
ROOM	R UW M
ROOM202	AA R OW OW EH M T UW Z IY R OW T UW
ROTATE	R OW T EY T
SLOW	S L OW
SPEED	S P IY D
STOP	S T AA P
TO	T UW
TO(2)	T IH
TO(3)	T AH
TO(2)	T IH
TO(3)	T AH
TURN	T ER N
UP	AH P
YO	Y OW
